object Form2: TForm2
  Left = 252
  Top = 159
  Width = 609
  Height = 529
  VertScrollBar.Range = 19
  Caption = 'Memo'
  Color = clBackground
  Menu = MainMenu1
  PixelsPerInch = 75
  TextHeight = 15
  TextWidth = 5
  object Memo1: TMemo
    Left = 0
    Top = 0
    Width = 609
    Height = 485
    Align = alClient
    Lines.Strings = (
      'Memo1')
    TabOrder = 0
  end
  object StatusBar1: TStatusBar
    Left = 0
    Top = 485
    Width = 609
    Height = 19
    Panels = <
      item
      end>
    SimplePanel = True
    SimpleText = 'fallmemo.txt'
  end
  object ActionList1: TActionList
    Images = ImageList1
    Left = 288
    Top = 248
    object DateiNeu: TAction
      Category = 'Datei'
      Caption = '&Neu'
      Hint = 'Memo erstellen'
      ImageIndex = 0
    end
    object DateiOeffnen: TAction
      Category = 'Datei'
      Caption = '&'#214'ffnen'
      Hint = 'Memo '#246'fnen'
      ImageIndex = 1
    end
    object DateiSpeichern: TAction
      Category = 'Datei'
      Caption = '&Speichern'
      Hint = 'Memo speicher'
      ImageIndex = 2
    end
    object DateiSpeichernUnter: TAction
      Category = 'Datei'
      Caption = '&Speichern &als'
      Hint = 'Memo speichern unter'
    end
    object DateiBeenden: TAction
      Category = 'Datei'
      Caption = '&Beenden'
      Hint = 'Memo Editor beenden'
      ImageIndex = 3
    end
  end
  object ImageList1: TImageList
    Left = 432
    Top = 256
    Bitmap = {
      494D474C01000100100000001000000004000000424D360C0000000000003600
      00002800000020000000200000000100180000000000000C0000120B0000120B
      00000000000000000000FFFFFFFFFFFFFFFFFFFFFFFFFFFFFFFFFFFFFFFFFFFF
      FFFF0000000000007B7D7B0000007B7D7B7B7D7B000000000000FFFFFFFFFFFF
      0000000000000000000000000000000000000000000000000000000000000000
      00FFFFFFFFFFFFFFFFFFFFFFFFFFFFFFFFFFFFFFFFFFFFFFFFFFFFFFFFFFFFFF
      FFFF000000000000BDBEBD000000BDBEBDBDBEBD000000000000FFFFFFFFFFFF
      0000000000830000830000830000830000830000830000830000830000830000
      00FFFFFFFFFFFFFFFFFFFFFFFFFFFFFFFFFFFFFFFFFFFFFFFFFFFFFFFFFFFFFF
      FFFF000000000000BDBEBDBDBEBDBDBEBDBDBEBD000000000000FFFFFFFFFFFF
      0000000000830000830000830000830000830000830000830000830000830000
      00FFFFFFFFFFFFFFFFFFFFFFFFFFFFFFFFFFFFFFFFFFFFFFFFFFFFFFFFFFFFFF
      FFFF000000000000000000000000000000000000000000000000FFFFFFFFFFFF
      0000000000830000830000830000830000830000830000830000830000830000
      00FFFFFFFFFFFFFFFFFF00000000000000000000000000000000000000000000
      0000000000000000000000000000000000000000000000000000FFFFFFFFFFFF
      0000000000830000830000830000830000830000830000830000830000830000
      00FFFFFFFFFFFFFFFFFF000000FFFFFFFFFFFFFFFFFFFFFFFFFFFFFFFFFFFFFF
      FFFF000000FFFFFFFFFFFFFFFFFFFFFFFFFFFFFFFFFFFF000000FFFFFFFFFFFF
      0000000000830000830000830000830000830000830000830000830000830000
      00FFFFFFFFFFFFFFFFFF000000FFFFFFFFFFFFFFFFFFFFFFFFFFFFFFFFFFFFFF
      FFFF000000FFFFFFFFFFFFFFFFFFFFFFFFFFFFFFFFFFFF000000FFFFFFFFFFFF
      0000000000830000830000830000830000830000830000830000830000830000
      00FFFFFFFFFFFFFFFFFF000000FFFFFF000000000000FFFFFF000000000000BD
      BEBD000000FF0000FF0000FF00000000FFFF0000FF0000000000FFFFFFFFFFFF
      00000000008300008300008300008300008300008300008300FFFF0000830000
      00FFFFFFFFFFFFFFFFFF000000FFFFFFFFFFFFFFFFFFFFFFFFFFFFFFFFFFFFFF
      FFFFFFFFFF000000FFFFFF0000FF0000FF0000FFFFFFFFFFFFFFFFFFFFFFFFFF
      0000000000830000830000830000830000830000830000830000830000830000
      00FFFFFFFFFFFFFFFFFF000000FFFFFF000000000000000000000000FFFFFF00
      0000FFFFFF0000000000FF0000FF0000FF0000FF0000FFFFFFFFFFFFFFFFFFFF
      0000000000830000830000830000830000830000830000830000830000830000
      00FFFFFFFFFFFFFFFFFF000000FFFFFFFFFFFFFFFFFFFFFFFFFFFFFFFFFFFFFF
      FFFFFFFFFF0000FF0000FF0000FF0000FF0000FF0000FF0000FFFFFFFFFFFFFF
      000000000083000083FFFF00FFFF00FFFF00FFFF00FFFF000000830000830000
      00FFFFFFFFFFFFFFFFFF000000FFFFFF000000000000FFFFFF00000000000000
      0000000000000000FFFFFF0000FF0000FF0000FFFFFFFFFFFFFFFFFFFFFFFFFF
      000000000083000083FFFF00FFFF00FFFF00FFFF00FFFF000000830000830000
      00FFFFFFFFFFFFFFFFFF000000FFFFFFFFFFFFFFFFFFFFFFFF000000FFFFFFFF
      FFFF000000FFFFFFFFFFFF0000FF0000FF0000FFFFFFFFFFFFFFFFFFFFFFFFFF
      000000000083000083FFFF00FFFF00FFFF00FFFF00FFFF000000830000830000
      00FFFFFFFFFFFFFFFFFF000000FFFFFF000000BDBEBDFFFFFF000000FFFFFF00
      0000FFFFFFFFFFFF7B7D7B0000FF0000FF0000FFFFFFFFFFFFFFFFFFFFFFFFFF
      0000000000830000830000830000830000830000830000830000830000830000
      00FFFFFFFFFFFFFFFFFF000000FFFFFFFFFFFFFFFFFFFFFFFF000000000000FF
      FFFF0000FF0000FF0000FF0000FF0000FFFFFFFFFFFFFFFFFFFFFFFFFFFFFFFF
      0000000000830000830000830000830000830000830000830000830000830000
      00FFFFFFFFFFFFFFFFFF000000000000000000000000000000000000FFFFFFFF
      FFFFFFFFFFFFFFFFFFFFFFFFFFFFFFFFFFFFFFFFFFFFFFFFFFFFFFFFFFFFFFFF
      0000000000000000000000000000000000000000000000000000000000000000
      00FFFFFFFFFFFFFFFFFFFFFFFFFFFFFFFFFFFFFFFFFFFFFFFFFFFFFFFFFFFFFF
      FFFF00FFFFFFFFFFFFFFFFFFFFFFFFFFFFFFFFFFFFFFFF00FFFFFFFFFFFFFFFF
      FFFFFFFFFFFFFFFFFFFFFFFFFFFFFFFFFFFFFFFFFFFFFFFFFFFFFFFFFFFFFFFF
      FFFFFFFFFFFFFFFFFFFFFFFFFF00FFFF00FFFFFFFFFF7B7D7B7B7D7B7B7D7B00
      FFFF00FFFF7B7D7B7B7D7B7B7D7B7B7D7B00FFFF00FFFFFFFFFFFFFFFFFFFFFF
      FFFFFFFFFFFFFFFFFFFFFFFFFFFFFFFFFFFFFFFFFFFFFFFFFFFFFFFFFFFFFFFF
      FFFFFFFFFFFFFFFFFFFFFFFFFFFFFFFF00FFFF00000000000000000000000000
      000000000000000000000000000000000000FFFFFFFFFFFFFFFFFFFFFFFFFFFF
      FFFFFFFFFFFFFFFFFFFFFFFFFFFFFFFFFFFFFFFFFFFFFFFFFFFFFFFFFFFFFFFF
      FFFFFFFFFFFFFFFFFFFFFFFFFFFFFFFFFFFFFF000000FFFFFFFFFFFFFFFFFFFF
      FFFFFFFFFFFFFFFFFFFFFFFFFFFF0000007B7D7BFFFFFFFFFFFFFFFFFFFFFFFF
      FFFFFFFFFFFFFFFFFFFFFFFFFFFFFFFFFFFFFFFFFFFFFFFFFFFFFFFFFFFFFFFF
      FFFFFFFFFFFFFFFFFFFFFFFFFFFFFFFFFFFFFF000000FFFFFFFFFFFFFFFFFFFF
      FFFFFFFFFFFFFFFFFFFFFFFFFFFF0000007B7D7BFFFFFFFFFFFFFFFFFFFFFFFF
      000000000000000000000000000000000000000000000000000000000000FFFF
      FFFFFFFFFFFFFFFFFFFFFFFFFFFFFFFFFFFFFF000000FFFFFFFFFFFFFFFFFFFF
      FFFFFFFFFFFFFFFFFFFFFFFFFFFF0000007B7D7BFFFFFFFFFFFFFFFFFF000000
      00000000FFFFBDBEBD00FFFFBDBEBD00FFFFBDBEBD00FFFFBDBEBD00FFFF0000
      00FFFFFFFFFFFFFFFFFFFFFFFFFFFFFFFFFFFF000000FFFFFFFFFFFFFFFFFFFF
      FFFFFFFFFFFFFFFFFFFFFFFFFFFF0000007B7D7BFFFFFFFFFFFFFFFFFF000000
      FFFFFF00000000FFFFBDBEBD00FFFFBDBEBD00FFFFBDBEBD00FFFFBDBEBD00FF
      FF000000FFFFFFFFFFFF00FFFF00FFFF00FFFF000000FFFFFFFFFFFFFFFFFFFF
      FFFFFFFFFFFFFFFFFFFFFFFFFFFF00000000FFFF00FFFFFFFFFFFFFFFF000000
      00FFFFFFFFFF00000000FFFFBDBEBD00FFFFBDBEBD00FFFFBDBEBD00FFFFBDBE
      BD00FFFF000000FFFFFFFFFFFF00FFFF00FFFF000000FFFFFFFFFFFFFFFFFFFF
      FFFFFFFFFFFFFFFFFFFFFFFFFFFF00000000FFFF00FFFF00FFFFFFFFFF000000
      FFFFFF00FFFFFFFFFF0000000000000000000000000000000000000000000000
      00000000000000FFFFFFFFFFFFFFFFFFFFFFFF000000FFFFFFFFFFFFFFFFFFFF
      FFFF000000000000000000000000000000FFFFFFFFFFFFFFFFFFFFFFFF000000
      00FFFFFFFFFF00FFFFFFFFFF00FFFFFFFFFF00FFFFFFFFFF00FFFF000000FFFF
      FFFFFFFFFFFFFFFFFFFFFFFFFFFFFFFFFFFFFF000000FFFFFFFFFFFFFFFFFFFF
      FFFF000000FFFFFFFFFFFF000000FFFFFFFFFFFFFFFFFFFFFFFFFFFFFF000000
      FFFFFF00FFFFFFFFFF00FFFFFFFFFF00FFFFFFFFFF00FFFFFFFFFF000000FFFF
      FFFFFFFFFFFFFFFFFFFFFFFFFFFFFFFFFFFFFF000000FFFFFFFFFFFFFFFFFFFF
      FFFF000000FFFFFF00000000FFFFFFFFFFFFFFFFFFFFFFFFFFFFFFFFFF000000
      00FFFFFFFFFF00FFFFFFFFFF00FFFFFFFFFF000000000000000000FFFFFFFFFF
      FFFFFFFFFFFFFFFFFFFFFFFFFFFFFFFFFFFFFF000000FFFFFFFFFFFFFFFFFFFF
      FFFF000000000000FFFFFF00FFFF00FFFFFFFFFFFFFFFFFFFFFFFFFFFFFFFFFF
      00000000FFFFFFFFFF00FFFFFFFFFF000000FFFFFFFFFFFFFFFFFFFFFFFFFFFF
      FFFFFFFFFFFFFFFFFFFFFFFFFFFFFFFF00FFFF00000000000000000000000000
      0000000000FFFFFFFFFFFFFFFFFF00FFFF00FFFFFFFFFFFFFFFFFFFFFFFFFFFF
      7B7D7B0000000000000000000000007B7D7BFFFFFFFFFFFFFFFFFFFFFFFFFFFF
      FFFFFFFFFFFFFFFFFFFFFFFFFF00FFFF00FFFFFFFFFFFFFFFFFFFFFFFFFFFF00
      FFFF00FFFFFFFFFFFFFFFFFFFFFFFFFFFF00FFFF00FFFFFFFFFFFFFFFFFFFFFF
      FFFFFFFFFFFFFFFFFFFFFFFFFFFFFFFFFFFFFFFFFFFFFFFFFFFFFFFFFFFFFFFF
      FFFFFFFFFFFFFFFFFFFF00FFFFFFFFFFFFFFFFFFFFFFFFFFFFFFFFFFFFFFFF00
      FFFFFFFFFFFFFFFFFFFFFFFFFFFFFFFFFFFFFFFFFFFFFF00FFFFFFFFFFFFFFFF
      FFFFFFFFFFFFFFFFFFFFFFFFFFFFFFFFFFFFFFFFFFFFFFFFFFFFFFFFFFFFFFFF
      FFFFFFFFFFFFFFFFFFFF424DBE000000000000003E0000002800000020000000
      20000000010001000000000080000000120B0000120B00000200000002000000
      FFFFFF0000000000000000000000000000000000000000000000000000000000
      0000000000000000000000000000000000000000000000000000000000000000
      0000000000000000000000000000000000000000000000000000000000000000
      0000000000000000000000000000000000000000000000000000000000000000
      0000000000000000}
  end
  object MainMenu1: TMainMenu
    Images = ImageList1
    Left = 160
    Top = 240
    object Datei1: TMenuItem
      Caption = '&Datei'
      object Neu1: TMenuItem
        Action = DateiNeu
      end
      object ffnen1: TMenuItem
        Action = DateiOeffnen
      end
      object Speichern1: TMenuItem
        Action = DateiSpeichern
      end
      object Speichernals1: TMenuItem
        Action = DateiSpeichernUnter
      end
      object N1: TMenuItem
        Caption = '-'
      end
      object Beenden1: TMenuItem
        Action = DateiBeenden
      end
    end
  end
end
